NO ./path_to_the_north_texture
SO ./path_to_the_south_texture
WE ./path_to_the_west_texture
EA ./path_to_the_east_texture

F 220,100,0
C 225,30,0

        1111111111111111111111111
        1000000000110000000000001
        1011000001110000000000001
        1001000000000000000000001
111111111011000001110000000000001
100000000011000001110111100011111
11110111111111111100000010001
11110111111111 11101010010001111111111
110001  110101 1110000001000111111
100001  10000010110000001000000111111
10000011000000001101010010001111
11000001110101011111011110S0111
11110111 1110101 101111010001
11111111 1111111 1111111111111111111