NO ./textures/1.png
SO ./textures/2.png
WE ./textures/3.png
EA ./textures/4.png

C 56, 56, 56
F 112, 112, 112


11111111111111111111111111111111
100000000000000000000000000000001
1000011D10000000000000000000000001
10000000000000000000000000011111111
100N0000000000100000000000001111111
111111111111111111111111111111