NO ./textures/north.xpm
SO ./textures/south.xpm
WE ./textures/west.xpm
EA ./textures/east.xpm

F 100,100,100
C 50,50,200

11111111111111111
10000000000000001
10000001000000001
10000001000000001
10000001000000001
100000010000N0001
10000000000000001
10000000000000001
11111100111111001
10000000000000001
10000000000000001
10011111111100001
10000000000000001
10000000000000001
11111111111111111