NO ./textures/1.png
SO ./textures/2.png
WE ./textures/3.png
EA ./textures/4.png

C 56, 56, 56
F 112, 112, 112


11111111111111111
10S00000000000001
10000001000000001
10000001000000001
10000001000000001
10000001000010001
10000000000000001
10000000000000001
11111100111111001
10000000000000001
10000000000111111
100111111111
100000000001
100000000001
111111111111