NO ./textures/1.png
SO ./textures/2.png
WE ./textures/3.png
EA ./textures/4.png

C 56, 56, 56
F 112, 112, 112


11111111111111111
10000000000000001
10000001000000001
10000001000000001
10000001000000001
10000001000000001
100000000000N0001
10000000000000001
10000111111000001
10000000000000001
11111111111111111