NO ./textures/north.xpm
SO ./textures/south.xpm
WE ./textures/west.xpm
EA ./textures/east.xpm

C 56, 56, 56
F 112, 112, 112

1111111111
1000000001
1000N00001
1000000001
1000000001
1000000001
1000000001
1111111111