NO ./north_texture
SO ./south_texture
WE ./west_texture
EA ./east_texture




F    220,100,0
C    225,30,0



1111111111
1000000001
1011111101
101  100001
1011111001
1000000N01
1111111111