NO ./north_texture
SO ./south_texture
WE ./west_texture
EA ./east_texture




F    220,100,0
C    225,30,0



 11111111111111
100001100111
101111110111
101  10000111111
10111110N1111
10000000111
111111111111111